11
12 12
08 01 04 05 01 01 06 04 02 01 07 08 
06 01 01 05 06 05 10 06 07 05 09 03 
02 07 09 04 02 05 09 05 10 03 01 08 
01 09 01 08 01 06 07 08 04 09 05 10 
03 07 06 08 08 05 06 08 10 09 04 01 
03 03 04 07 08 02 06 06 05 01 03 07 
01 07 02 08 02 08 04 01 01 05 09 04 
01 02 03 10 01 04 09 09 06 08 08 01 
09 10 04 01 08 05 08 09 04 08 02 07 
01 09 04 05 06 01 02 05 06 07 03 01 
04 06 07 08 07 08 07 08 08 02 10 02 
07 03 08 03 08 07 06 02 04 10 10 06 
