11
12 12
07 04 09 08 07 02 08 03 04 08 09 06 
09 06 09 08 04 04 02 01 09 02 01 10 
03 05 10 02 06 08 04 04 05 03 03 01 
02 03 08 08 01 03 05 02 01 04 08 04 
10 06 10 08 03 01 03 09 07 08 01 09 
02 09 04 01 04 07 03 01 03 09 05 02 
09 04 08 06 09 02 08 01 05 09 09 02 
04 07 08 09 10 06 01 06 07 07 04 01 
01 09 09 03 04 01 07 06 01 10 08 03 
03 09 03 10 05 05 09 03 08 03 06 09 
05 08 04 10 06 02 10 01 03 09 04 02 
05 04 02 01 05 01 08 10 01 09 02 05 
