11
12 12
07 01 07 08 02 05 01 07 02 03 02 05 
10 06 03 04 05 02 06 03 04 02 07 09 
09 03 08 08 02 03 07 01 05 10 05 07 
01 04 07 03 05 06 09 09 02 03 02 05 
10 09 03 05 06 03 10 10 09 04 09 07 
10 08 07 07 03 04 09 03 07 03 08 06 
08 09 03 08 09 01 03 01 09 10 03 09 
03 01 06 06 03 08 07 08 09 08 09 02 
07 01 10 06 09 10 01 03 01 08 03 06 
06 03 02 05 09 07 05 07 09 10 09 04 
06 06 02 06 06 09 05 01 06 05 08 03 
02 05 10 10 01 04 01 04 06 01 08 07 
