11
12 12
05 03 10 04 02 05 09 03 01 06 06 10 
04 03 09 08 05 09 02 05 04 06 07 03 
07 09 10 03 10 06 10 05 06 01 06 09 
09 01 02 04 03 09 03 08 01 04 02 04 
04 08 01 10 06 06 09 04 08 09 04 08 
10 04 10 02 09 03 04 01 02 09 05 09 
07 01 10 04 01 01 09 08 07 04 06 07 
06 09 04 10 05 09 04 10 08 07 05 06 
09 07 02 06 06 02 10 07 05 06 01 03 
06 04 03 07 09 03 07 07 04 10 05 06 
07 03 06 04 06 07 07 02 05 05 07 03 
07 09 03 06 06 02 01 02 06 02 08 07 
