11
12 12
08 09 04 07 05 05 02 10 06 06 08 05 
08 04 05 01 09 09 02 06 03 04 03 05 
07 01 07 03 10 01 05 10 04 02 02 10 
10 06 01 06 07 01 06 10 05 07 04 05 
10 01 06 04 10 02 03 09 09 02 09 07 
01 03 05 10 01 03 05 02 06 05 03 05 
03 06 01 05 03 02 03 08 08 10 06 06 
05 01 04 05 02 03 03 10 09 03 03 08 
09 06 09 04 10 05 05 07 10 09 06 07 
07 01 08 03 08 03 07 05 08 02 04 03 
02 07 04 09 04 03 09 07 01 02 03 07 
01 06 05 07 08 10 04 05 08 09 09 02 
