11
12 12
03 06 09 07 08 08 03 03 10 05 02 10 
07 10 09 03 06 06 05 10 02 03 06 01 
09 04 10 04 10 07 08 10 10 08 07 10 
04 06 08 07 07 06 09 03 06 05 05 02 
07 02 07 04 04 06 06 04 03 09 03 06 
04 07 02 09 07 03 02 05 07 03 10 02 
06 01 04 07 05 10 03 10 04 05 05 01 
06 10 07 04 05 03 09 09 08 06 09 02 
03 06 08 05 06 05 06 05 03 10 04 01 
08 08 09 08 04 01 04 09 03 06 03 01 
04 08 03 10 08 06 04 05 04 03 02 02 
04 03 06 04 06 02 03 08 03 07 05 01 
