11
12 12
01 01 03 05 04 04 07 03 09 03 04 05 
04 05 04 07 09 05 08 04 10 09 01 01 
09 09 01 06 02 05 04 07 04 10 03 02 
10 09 03 04 05 01 03 04 02 10 09 10 
09 10 02 04 06 02 05 03 06 04 09 01 
03 09 08 01 02 05 09 02 10 04 06 10 
08 10 09 01 02 05 08 06 07 06 01 10 
03 09 03 05 06 01 05 05 01 06 02 02 
06 10 01 09 04 09 08 03 07 10 04 09 
02 01 04 04 09 05 09 01 02 06 05 02 
04 08 04 06 09 06 07 10 01 09 10 04 
07 01 07 10 08 09 10 05 02 06 07 07 
