11
12 12
10 03 07 06 04 03 05 08 05 03 08 10 
03 04 08 04 02 06 08 09 06 09 04 03 
05 02 02 06 10 06 02 01 07 05 06 04 
01 09 10 02 04 05 08 05 07 04 07 06 
03 05 02 01 04 02 06 06 03 03 02 08 
05 09 03 04 07 04 01 04 06 03 09 01 
08 03 03 06 10 02 01 09 04 01 08 10 
01 06 04 05 02 01 05 09 06 10 03 06 
05 02 04 10 06 09 03 08 10 07 02 08 
08 04 10 01 04 05 02 08 06 04 04 03 
05 02 03 10 01 09 08 05 06 07 09 01 
08 08 05 04 02 04 07 04 01 02 10 01 
