11
12 12
01 01 02 02 03 03 04 04 05 05 06 06 
01 02 03 06 01 10 05 08 09 04 06 02 
03 01 02 07 05 01 07 02 09 10 09 05 
02 05 04 10 09 09 01 09 08 08 09 04 
09 04 08 02 01 08 04 05 10 07 06 02 
01 10 10 07 09 04 05 09 05 10 10 03 
06 06 04 08 04 08 05 04 09 01 09 09 
01 07 09 02 10 09 10 08 03 03 09 03 
09 10 01 08 09 02 06 09 07 02 03 05 
03 06 09 07 03 07 06 04 10 03 05 07 
02 09 03 02 02 10 08 07 03 10 06 03 
01 01 04 10 02 09 02 10 06 04 03 06 
