11
12 12
7 4 9 8 7 2 8 3 4 8 9 6 
9 6 9 8 4 4 2 1 9 2 1 10 
3 5 10 2 6 8 4 4 5 3 3 1 
2 3 8 8 1 3 5 2 1 4 8 4 
10 6 10 8 3 1 3 9 7 8 1 9 
2 9 4 1 4 7 3 1 3 9 5 2 
9 4 8 6 9 2 8 1 5 9 9 2 
4 7 8 9 10 6 6 6 7 7 4 1 
1 9 9 3 4 1 7 6 1 10 8 3 
3 9 3 10 5 5 9 3 8 3 6 9 
5 8 4 10 6 2 10 1 3 9 4 2 
5 4 2 1 5 1 8 10 1 9 2 5 
