11
12 12
10 3 7 6 4 3 5 5 5 3 8 10 
3 4 8 4 2 6 8 9 6 9 4 3 
5 2 2 6 10 6 2 1 7 5 6 4 
1 9 10 2 4 5 8 5 7 4 7 6 
3 9 2 1 4 2 6 6 3 3 2 8 
5 9 3 4 7 4 1 4 6 3 9 1 
8 3 3 6 10 2 1 9 6 1 8 10 
1 6 4 5 2 1 5 9 6 10 3 6 
5 2 4 10 6 9 3 8 10 7 2 8 
8 2 10 1 4 5 2 8 6 4 4 3 
5 2 3 10 1 9 8 5 6 7 9 1 
8 8 5 4 2 4 7 4 1 2 10 1 
