11
12 12
5 3 10 4 2 5 9 3 1 6 6 10 
4 3 9 8 5 9 2 5 4 6 6 3 
7 9 10 3 10 6 10 5 6 1 6 9 
9 1 2 4 3 3 3 8 1 4 2 4 
4 8 1 10 6 6 9 4 8 9 4 8 
10 4 10 2 9 3 9 1 2 9 5 9 
7 1 10 4 1 1 9 8 7 4 6 7 
6 9 4 10 5 9 4 10 8 7 5 6 
9 7 2 6 6 2 10 7 5 6 5 3 
6 4 3 7 9 3 7 7 4 10 5 6 
7 3 6 4 6 7 7 2 5 5 7 3 
7 9 3 6 6 2 1 2 6 2 8 7 
