11
12 12
8 9 4 7 5 5 2 10 6 6 8 5 
8 4 5 1 9 9 2 6 3 4 3 5 
7 7 7 3 10 1 5 10 4 2 2 10 
10 6 6 6 7 1 6 10 5 7 4 5 
10 1 6 4 10 2 3 9 9 2 9 7 
1 3 5 10 1 3 3 2 6 5 5 5 
3 6 1 5 3 2 3 8 8 10 6 6 
5 1 4 5 2 3 3 10 9 3 3 8 
9 6 9 4 10 5 5 7 10 9 6 7 
7 1 8 3 8 3 7 5 8 2 4 3 
2 7 4 9 4 3 9 7 1 2 3 7 
1 6 5 7 8 10 4 5 8 9 9 2 
