11
12 12
1 9 10 7 5 10 3 9 7 0 3 7 
10 3 0 1 10 2 10 7 1 2 6 4 
5 8 2 7 6 10 1 6 5 10 7 7 
3 3 2 10 1 2 1 7 8 0 10 1 
10 4 7 2 8 8 10 7 8 0 9 6 
7 3 1 8 2 8 5 9 3 7 2 4 
1 0 9 1 9 9 5 5 8 1 3 9 
7 6 10 9 4 5 10 9 8 9 9 0 
4 2 10 2 3 7 6 6 3 7 10 10 
0 5 1 7 7 4 1 2 4 2 4 0 
6 0 9 0 8 3 5 10 2 9 4 2 
4 1 3 7 3 1 9 9 1 0 5 9 
