11
12 12
1 1 2 2 3 3 4 4 5 5 6 6 
1 2 3 6 1 10 5 8 9 4 6 2 
3 1 2 7 5 1 7 2 9 10 9 5 
2 5 4 10 9 9 1 9 8 8 9 4 
9 4 8 2 1 8 4 5 10 7 6 2 
1 10 10 7 9 4 5 9 5 10 10 3 
6 6 4 4 4 8 5 4 9 1 9 9 
1 7 9 2 10 9 10 8 3 3 9 3 
9 10 1 8 9 2 6 9 7 2 3 5 
3 6 9 7 3 7 6 4 10 3 5 7 
2 9 3 2 2 10 8 7 3 10 6 3 
1 1 4 10 2 9 2 10 6 4 3 6 
