11
12 12
1 1 3 5 4 4 7 3 9 3 4 5 
4 5 4 7 9 5 8 4 10 9 1 1 
9 9 1 6 2 5 4 7 4 10 3 2 
10 9 3 4 5 1 3 4 2 10 9 10 
9 10 2 4 6 2 5 3 6 4 9 10 
3 9 8 1 2 5 9 2 10 4 6 10 
8 10 9 1 2 5 8 6 6 6 1 10 
3 9 3 5 6 1 5 5 1 6 2 2 
6 10 1 9 4 9 8 3 7 10 4 9 
2 1 4 4 9 5 9 1 2 6 5 2 
4 8 4 6 9 6 7 10 1 9 10 4 
7 1 7 10 8 9 10 5 2 6 7 7 
