11
12 12
7 7 7 8 2 5 1 7 2 3 2 5 
10 6 3 4 5 2 6 3 4 2 7 9 
9 3 8 8 2 3 7 1 5 10 5 7 
1 4 7 3 5 6 9 9 2 3 2 5 
10 9 3 5 6 3 10 10 9 4 9 7 
10 9 7 7 3 4 9 3 7 3 8 6 
8 9 3 8 9 1 3 1 9 10 3 9 
3 1 6 6 3 8 7 8 9 8 9 2 
7 1 10 6 9 10 1 1 1 8 3 6 
6 3 2 5 9 7 5 7 9 10 9 4 
6 6 2 6 6 9 5 1 6 5 8 3 
2 5 10 10 1 4 1 4 6 1 8 7 
