11
12 12
3 6 9 7 8 8 3 3 10 5 2 10 
7 10 9 3 6 6 5 10 2 3 6 1 
9 4 10 4 10 7 8 10 10 8 7 10 
4 6 8 7 7 6 9 3 6 5 5 2 
7 2 7 4 4 6 6 4 3 9 3 6 
4 7 2 9 7 3 2 5 7 3 10 2 
6 1 4 7 5 10 3 10 4 5 5 1 
6 10 7 4 5 3 9 9 8 6 9 2 
3 6 8 5 5 5 5 5 3 10 4 1 
8 8 9 8 4 1 4 9 3 6 3 1 
4 8 3 10 8 6 4 5 4 3 2 2 
4 3 6 4 6 2 3 3 3 7 5 1 
